Key assignments

Note: some commands use the insert key, only the numpad insert is used at this point in ttime.

General 
Quit NVDA: insert+q
NVDA menu: insert+n (not complete yet)
Time and date: insert+F12 
Toggle speech on and off: insert+s 

Edit fields / documents / virtualBuffers
current line: numpad8
previous line: numpad7
top of text: shift+numpad7
next line: numpad9
bottom of text: shift+numpad9
current character: numpad2
previous character: numpad1
start of line: shift+numpad1
next character: numpad3
end of line: shift+numpad3
current word: numpad5
previous word: numpad4
next word: numpad6
Move to caret: numpad subtract
Read format info: insert+f
say all: insert+downArrow

Object navigation (moving only moves the navigator, not the focus)
read currentObject: insert+numpad5
move to and read previous object: insert+numpad4
move to and read next object: insert+numpad6
move to and read parent object: insert+numpad8
move to and read first child object: insert+numpad2
move to and read left object: insert+shift+numpad4
move to and read right object: insert+shift+numpad6
move to and read up object: insert+shift+numpad8
move to and read down object: insert+shift+numpad2
Do object default action: insert+numpadReturn
Read current object and decendants: insert+numpadPlus
read current object and ansesters: insert+shift+numpadPlus

